32 32 32 32 32 32 32 32 32 32 32 32 32 32 32 32 32 32 32 32 32 32 32 32 32 32 32 32 32 32 32 32 32 32 32 32 32 32 32 32 32 32 32 32 32 32 32 32 32 32
32 32 32 32 32 32 32 32 32 32 32 32 32 32 32 32 32 32 32 32 32 32 32 32 32 32 32 32 32 32 32 32 32 32 32 32 32 32 32 32 32 32 32 32 32 32 32 32 32 32
32 32 32 32 32 32 32 32 32 32 32 32 32 32 32 32 32 32 32 32 32 32 32 32 32 32 32 32 32 32 32 32 32 32 32 32 32 32 32 32 32 32 32 32 32 32 32 32 32 32
32 32 32 32 32 32 32 32 32 32 32 32 32 32 32 32 32 32 32 32 32 32 32 32 32 32 32 32 32 32 32 32 32 32 32 32 32 32 32 32 32 32 32 32 32 32 32 32 32 32
32 32 32 32 32 32 32 32 32 32 32 32 32 32 32 32 32 32 32 32 32 32 32 32 32 32 32 32 32 32 32 32 32 32 32 32 32 32 32 32 32 32 32 32 32 32 32 32 32 32
32 32 32 32 32 32 32 32 32 32 32 32 32 32 32 32 32 32 32 32 32 32 32 32 32 32 32 32 32 32 32 32 32 32 32 32 32 32 32 32 32 32 32 32 32 32 32 32 32 32
32 32 32 32 32 32 32 32 32 32 32 32 32 32 32 32 32 32 32 32 32 32 32 32 32 32 32 32 32 32 32 32 32 32 32 32 32 32 32 32 32 32 32 32 32 32 32 32 32 32
32 32 32 32 32 32 32 32 32 32 32 32 32 32 32 32 32 32 32 32 32 32 32 32 32 32 32 32 32 32 32 32 32 32 32 32 32 32 32 32 32 32 32 32 32 32 32 32 32 32
32 32 32 32 32 32 32 32 32 32 32 32 32 32 32 32 32 32 32 32 32 32 32 32 32 32 32 32 32 32 32 32 32 32 32 32 32 32 32 32 32 32 32 32 32 32 32 32 32 32
32 32 32 32 32 32 32 32 32 32 32 32 32 32 32 32 32 32 32 32 32 32 32 32 32 32 32 32 32 32 32 32 32 32 32 32 32 32 32 32 32 32 32 32 32 32 32 32 32 32
32 32 32 32 32 32 32 32 32 32 32 35 33 33 33 33 33 33 33 33 33 33 33 33 33 33 33 37 32 32 32 32 32 32 32 32 32 32 32 32 32 32 32 32 32 32 32 32 32 32
32 32 32 32 32 32 32 32 32 32 32 34 31 31 31 31 31 31 31 31 31 31 31 31 31 31 31 36 32 32 32 32 32 35 33 33 33 33 33 33 33 37 32 32 32 32 32 32 32 32
32 32 32 32 32 32 32 32 32 32 32 34 31 31 31 31 31 31 31 31 31 31 31 31 31 31 31 44 33 33 33 33 33 42 31 31 31 31 31 31 31 36 32 32 32 32 32 32 32 32
32 32 32 32 32 32 32 32 32 32 32 34 31 31 31 31 31 31 31 31 31 31 31 31 31 31 31 31 31 31 31 31 31 31 31 31 31 31 31 31 31 36 32 32 32 32 32 32 32 32
32 32 32 32 32 32 32 32 32 32 32 34 31 31 31 31 31 31 31 31 31 31 31 31 31 31 31 43 38 38 38 38 38 41 31 31 31 31 31 31 31 36 32 32 32 32 32 32 32 32
32 32 32 32 32 32 32 32 32 32 32 34 31 31 31 31 31 31 31 31 31 31 31 31 31 31 31 36 32 32 32 32 32 39 38 38 38 31 38 38 38 40 32 32 32 32 32 32 32 32
32 32 32 32 32 32 32 32 32 32 32 39 38 38 38 38 38 38 38 38 38 38 41 31 31 43 38 40 32 32 32 32 32 32 32 32 34 31 36 32 32 32 32 32 32 32 32 32 32 32
32 32 32 32 32 32 32 32 32 32 32 32 32 32 32 32 32 32 32 32 32 32 34 31 31 36 32 32 32 32 32 32 32 32 32 32 34 31 36 32 32 32 32 32 32 32 32 32 32 32
32 32 32 32 32 32 32 32 32 32 32 32 32 32 32 32 32 32 32 32 32 32 34 31 31 36 32 32 32 32 32 32 32 32 32 32 34 31 36 32 32 32 32 32 32 32 32 32 32 32
32 32 32 32 32 32 32 32 32 32 32 32 32 32 32 32 32 32 32 32 32 32 34 31 31 36 32 32 32 32 32 32 32 32 32 32 34 31 36 32 32 32 32 32 32 32 32 32 32 32
32 32 32 32 32 32 32 32 32 32 32 32 32 32 32 32 32 32 32 32 32 32 34 31 31 36 32 32 32 32 32 32 32 32 32 32 34 31 36 32 32 32 32 32 32 32 32 32 32 32
32 32 32 32 32 32 32 32 32 32 32 32 32 32 32 32 32 32 32 32 32 32 34 31 31 36 32 32 32 32 32 32 32 32 32 32 34 31 36 32 32 32 32 32 32 32 32 32 32 32
32 32 32 32 32 32 32 32 32 32 32 32 32 32 32 32 32 32 32 32 32 32 34 31 31 36 32 32 35 33 37 32 32 32 32 32 34 31 36 32 32 32 32 32 32 32 32 32 32 32
32 32 32 32 32 32 32 32 32 32 32 32 32 32 32 32 32 32 32 32 32 32 34 31 31 36 32 32 34 31 36 32 32 32 32 32 34 31 36 32 32 32 32 32 32 32 32 32 32 32
32 32 32 32 32 32 32 32 32 32 32 32 32 32 35 33 33 33 33 33 33 33 42 31 31 36 32 32 34 31 36 32 32 32 32 32 34 31 36 32 32 32 32 32 32 32 32 32 32 32
32 32 32 32 32 32 32 32 32 32 32 32 32 32 34 31 31 31 31 31 31 31 31 31 31 36 32 32 34 31 36 32 32 32 32 32 34 31 36 32 32 32 32 32 32 32 32 32 32 32
32 32 32 32 32 32 32 32 32 32 32 32 32 32 34 31 31 31 31 31 31 31 31 31 31 36 32 32 34 31 36 32 32 32 32 32 34 31 36 32 32 32 32 32 32 32 32 32 32 32
32 32 32 32 32 32 32 32 32 32 32 32 32 32 34 31 31 43 38 38 38 38 38 38 38 40 32 32 34 31 36 32 32 32 32 32 39 38 40 32 32 32 32 32 32 32 32 32 32 32
32 32 32 32 32 32 32 32 32 32 32 32 32 32 34 31 31 36 32 32 32 32 32 32 32 32 32 32 34 31 36 32 32 32 32 32 32 32 32 32 32 32 32 32 32 32 32 32 32 32
32 32 32 32 32 32 32 32 32 32 32 32 32 32 34 31 31 36 32 32 32 32 32 32 32 32 32 32 34 31 36 32 32 32 32 32 32 32 32 32 32 32 32 32 32 32 32 32 32 32
32 32 32 32 32 32 32 32 32 32 32 32 32 32 34 31 31 36 32 32 32 32 32 32 32 32 32 32 34 31 36 32 32 32 32 32 32 32 32 32 32 32 32 32 32 32 32 32 32 32
32 32 32 32 32 32 32 32 32 32 32 35 33 33 33 31 31 33 33 33 37 32 32 32 35 33 33 33 33 31 33 33 33 33 33 33 33 33 33 33 33 37 32 32 32 32 32 32 32 32
32 32 32 32 32 32 32 32 32 32 32 34 31 31 31 31 31 31 31 31 36 32 32 32 34 31 31 31 31 31 31 31 31 31 31 31 31 31 31 31 31 36 32 32 32 32 32 32 32 32
32 32 32 32 32 32 32 32 32 32 32 34 31 31 31 31 31 31 31 31 36 32 32 32 34 31 43 38 38 38 38 38 38 38 38 38 38 38 38 38 38 40 32 32 32 32 32 32 32 32
32 32 32 32 32 32 32 32 32 32 32 34 31 31 31 31 31 31 31 31 36 32 32 32 34 31 36 32 32 32 32 32 32 32 32 32 32 32 32 32 32 32 32 32 32 32 32 32 32 32
32 32 32 32 32 32 32 32 32 32 32 45 31 31 31 31 31 31 31 31 36 32 32 32 34 31 36 32 32 32 32 32 32 32 32 32 32 32 32 32 32 32 32 32 32 32 32 32 32 32
32 32 32 32 32 32 32 32 32 32 32 34 31 31 31 31 31 31 31 31 36 32 32 32 34 31 44 33 33 33 33 33 37 32 32 32 32 32 32 32 32 32 32 32 32 32 32 32 32 32
32 32 32 32 32 32 32 32 32 32 32 34 31 31 31 31 31 31 31 31 36 32 32 32 34 31 31 31 31 31 31 31 36 32 32 32 32 32 32 32 32 32 32 32 32 32 32 32 32 32
32 32 32 32 32 32 32 32 32 32 32 34 31 31 31 31 31 31 31 31 36 32 32 32 34 31 43 38 38 38 41 31 44 33 33 33 37 32 32 32 32 32 32 32 32 32 32 32 32 32
32 32 32 32 32 32 32 32 32 32 32 39 38 38 38 38 41 31 43 38 40 32 32 32 34 31 36 32 32 32 34 31 31 31 31 31 36 32 32 32 32 32 32 32 32 32 32 32 32 32
32 32 32 32 32 32 32 32 32 32 32 32 32 32 32 32 34 31 44 33 33 33 33 33 42 31 36 32 32 32 34 31 43 38 38 38 40 32 32 32 32 32 32 32 32 32 32 32 32 32
32 32 32 32 32 32 32 32 32 32 32 32 32 32 32 32 34 31 31 31 31 31 31 31 31 31 36 32 35 33 42 31 36 32 32 32 32 32 32 32 32 32 32 32 32 32 32 32 32 32
32 32 32 32 32 32 32 32 32 32 32 32 32 32 32 32 39 38 38 38 38 38 38 38 38 38 40 32 34 31 31 31 36 32 32 32 32 32 32 32 32 32 32 32 32 32 32 32 32 32
32 32 32 32 32 32 32 32 32 32 32 32 32 32 32 32 32 32 32 32 32 32 32 32 32 32 32 32 39 38 38 38 40 32 32 32 32 32 32 32 32 32 32 32 32 32 32 32 32 32
32 32 32 32 32 32 32 32 32 32 32 32 32 32 32 32 32 32 32 32 32 32 32 32 32 32 32 32 32 32 32 32 32 32 32 32 32 32 32 32 32 32 32 32 32 32 32 32 32 32
32 32 32 32 32 32 32 32 32 32 32 32 32 32 32 32 32 32 32 32 32 32 32 32 32 32 32 32 32 32 32 32 32 32 32 32 32 32 32 32 32 32 32 32 32 32 32 32 32 32
32 32 32 32 32 32 32 32 32 32 32 32 32 32 32 32 32 32 32 32 32 32 32 32 32 32 32 32 32 32 32 32 32 32 32 32 32 32 32 32 32 32 32 32 32 32 32 32 32 32
32 32 32 32 32 32 32 32 32 32 32 32 32 32 32 32 32 32 32 32 32 32 32 32 32 32 32 32 32 32 32 32 32 32 32 32 32 32 32 32 32 32 32 32 32 32 32 32 32 32
32 32 32 32 32 32 32 32 32 32 32 32 32 32 32 32 32 32 32 32 32 32 32 32 32 32 32 32 32 32 32 32 32 32 32 32 32 32 32 32 32 32 32 32 32 32 32 32 32 32
32 32 32 32 32 32 32 32 32 32 32 32 32 32 32 32 32 32 32 32 32 32 32 32 32 32 32 32 32 32 32 32 32 32 32 32 32 32 32 32 32 32 32 32 32 32 32 32 32 32