32 32 32 32 32 32 32 32 32 32 32 32 32 32 32 32 32 32 32 32 32 32 32 32 32 32 32 32 32 32 32 32 32 32 32 32 32 32 32 32 32 32 32 32 32 32 32 32 32 32
32 32 32 32 32 32 32 32 32 32 32 32 32 32 32 32 32 32 32 32 32 32 32 32 32 32 32 32 32 32 32 32 32 32 32 32 32 32 32 32 32 32 32 32 32 32 32 32 32 32
32 32 32 32 32 32 32 32 32 32 32 32 32 32 32 32 32 32 32 32 32 32 32 32 32 32 32 32 32 32 32 32 32 32 32 32 32 32 32 32 32 32 32 32 32 32 32 32 32 32
32 32 32 32 32 32 32 32 32 32 32 32 32 32 32 32 32 32 32 32 32 32 32 32 32 32 32 32 32 32 32 32 32 32 32 32 32 32 32 32 32 32 32 32 32 32 32 32 32 32
32 32 32 32 32 32 32 32 32 32 32 32 32 32 32 32 32 32 32 32 32 32 32 32 32 32 32 32 32 32 32 32 32 32 32 32 32 32 32 32 32 32 32 32 32 32 32 32 32 32
32 32 32 32 32 32 32 32 32 32 32 32 32 32 32 32 32 32 32 32 32 32 32 32 32 32 32 32 32 32 32 32 32 32 32 32 32 32 32 32 32 32 32 32 32 32 32 32 32 32
32 32 32 32 32 32 32 32 32 32 32 32 32 32 32 32 32 32 32 32 32 32 32 32 32 32 32 32 32 32 32 32 32 32 32 32 32 32 32 32 32 32 32 32 32 32 32 32 32 32
32 32 32 32 32 32 32 32 32 32 32 32 32 32 32 32 32 32 32 32 32 32 32 32 33 33 33 33 33 33 33 33 33 33 33 33 33 33 33 33 37 32 32 32 32 32 32 32 32 32
32 32 32 32 32 32 32 32 32 32 32 32 32 32 32 32 32 32 32 32 32 32 32 32 31 31 31 31 31 31 31 31 31 31 31 31 31 31 31 31 46 32 32 32 32 32 32 32 32 32
32 32 32 32 32 32 32 32 32 32 32 32 32 32 32 32 32 32 32 32 32 32 32 32 38 38 38 38 41 31 43 38 38 38 41 31 43 38 38 38 40 32 32 32 32 32 32 32 32 32
32 32 32 32 32 32 32 32 32 32 32 32 32 32 32 32 32 32 32 32 32 32 32 32 32 32 32 32 34 31 36 32 32 32 34 31 36 32 32 32 32 32 32 32 32 32 32 32 32 32
32 32 32 32 32 32 32 32 32 32 32 32 32 32 32 32 32 32 32 32 32 32 32 32 32 32 32 32 34 31 36 32 32 32 34 31 36 32 32 32 32 32 32 32 32 32 32 32 32 32
32 32 32 32 32 32 32 32 32 35 33 33 33 33 33 33 33 33 33 33 33 33 33 33 33 33 33 33 42 31 36 32 32 32 34 31 36 32 32 32 32 32 32 32 32 32 32 32 32 32
32 32 32 32 32 32 32 32 32 34 31 31 31 31 31 31 31 31 31 31 31 31 31 31 31 31 31 31 31 31 36 32 32 32 34 31 36 32 32 32 32 32 32 32 32 32 32 32 32 32
32 32 32 32 32 32 32 32 32 34 31 43 38 38 38 38 38 38 38 38 38 38 38 38 38 38 38 38 38 38 40 32 32 32 34 31 36 32 32 32 32 32 32 32 32 32 32 32 32 32
32 32 32 32 32 32 32 32 32 34 31 36 32 32 32 32 32 32 32 32 32 32 32 32 32 32 32 32 32 32 32 32 32 32 34 31 36 32 32 32 32 32 32 32 32 32 32 32 32 32
32 32 32 32 32 32 32 32 32 34 31 36 32 32 32 32 32 32 32 32 32 32 32 32 32 32 32 32 32 32 32 32 32 32 34 31 36 32 32 32 32 32 32 32 32 32 32 32 32 32
32 32 32 32 32 32 32 32 32 34 31 36 32 32 32 32 32 32 32 32 32 32 32 32 32 32 32 32 32 32 32 32 32 32 34 31 36 32 32 32 32 32 32 32 32 32 32 32 32 32
32 32 32 32 32 32 32 32 32 34 31 44 33 33 33 33 33 33 33 33 33 37 32 32 32 32 32 32 32 32 32 32 32 32 34 31 36 32 32 32 32 32 32 32 32 32 32 32 32 32
32 32 32 32 32 32 32 32 32 34 31 31 31 31 31 31 31 31 31 31 31 36 32 32 32 32 32 32 35 33 33 33 33 33 42 31 44 33 33 33 37 32 32 32 32 32 32 32 32 32
32 32 32 32 32 32 32 32 32 34 31 43 38 38 38 38 38 38 38 38 38 40 32 32 32 32 32 32 34 31 31 31 31 31 31 31 31 31 31 31 36 32 32 32 32 32 32 32 32 32
32 32 32 32 32 32 32 32 32 34 31 36 32 32 32 32 32 32 32 32 32 32 32 32 32 32 32 32 34 31 31 31 31 31 31 31 31 31 31 31 36 32 32 32 32 32 32 32 32 32
32 32 32 32 32 32 32 32 32 34 31 36 32 32 32 32 32 32 32 32 32 32 32 32 32 32 32 32 34 31 31 31 31 31 31 31 31 31 31 31 36 32 32 32 32 32 32 32 32 32
32 32 32 32 32 32 32 32 32 34 31 36 32 32 32 32 32 32 32 32 32 32 32 32 32 32 35 33 42 31 31 31 31 31 31 31 31 31 31 31 36 32 32 32 32 32 32 32 32 32
32 32 32 32 32 32 32 32 32 34 31 36 32 32 32 32 32 32 32 32 32 32 32 32 32 32 34 31 31 31 43 38 38 38 38 38 38 38 41 31 36 32 32 32 32 32 32 32 32 32
32 32 32 32 32 32 32 32 32 34 31 36 32 32 32 32 32 32 32 32 32 32 32 32 32 32 34 31 31 31 36 32 32 32 32 32 32 32 34 31 36 32 32 32 32 32 32 32 32 32
32 32 32 32 32 32 32 32 32 34 31 44 33 33 33 33 37 32 32 32 32 32 32 32 32 32 34 31 31 31 36 32 32 32 32 32 32 32 34 31 36 32 32 32 32 32 32 32 32 32
32 32 32 32 32 32 32 32 32 34 31 31 31 31 31 31 36 32 32 32 32 32 32 32 32 32 39 38 38 38 40 32 32 32 32 32 32 32 34 31 36 32 32 32 32 32 32 32 32 32
32 32 32 32 32 32 32 32 32 34 31 31 31 31 31 31 44 33 33 33 33 33 33 33 33 33 33 33 33 33 33 33 33 33 33 37 32 32 34 31 36 32 32 32 32 32 32 32 32 32
32 32 32 32 32 32 32 32 32 34 31 31 31 31 31 31 31 31 31 31 31 31 31 31 31 31 31 31 31 31 31 31 31 31 31 36 32 32 34 31 36 32 32 32 32 32 32 32 32 32
32 32 32 32 32 32 32 32 32 34 31 31 31 31 31 31 43 38 38 38 38 38 38 38 38 38 38 38 38 38 41 31 31 31 31 36 32 32 34 31 36 32 32 32 32 32 32 32 32 32
32 32 32 32 32 32 32 32 32 34 31 31 31 31 31 31 36 32 32 32 32 32 32 32 32 32 32 32 32 32 34 31 31 31 31 36 32 32 34 31 36 32 32 32 32 32 32 32 32 32
32 32 32 32 32 32 32 32 32 39 38 38 38 38 38 38 40 32 32 32 32 32 32 32 32 32 32 32 32 32 34 31 31 31 31 36 32 32 34 31 36 32 32 32 32 32 32 32 32 32
32 32 32 32 32 32 32 32 32 32 32 32 32 32 32 32 32 32 32 32 32 32 32 32 32 32 32 32 32 32 34 31 31 31 31 36 32 32 34 31 36 32 32 32 32 32 32 32 32 32
32 32 32 32 32 32 32 32 32 32 32 32 32 32 32 32 32 32 32 32 32 32 32 32 32 32 32 32 32 32 39 38 38 38 38 40 32 32 34 31 36 32 32 32 32 32 32 32 32 32
32 32 32 32 32 32 32 32 32 32 32 32 32 32 32 32 32 32 32 32 32 32 32 32 32 32 32 32 32 32 32 32 32 32 32 32 32 32 34 31 36 32 32 32 32 32 32 32 32 32
32 32 32 32 32 32 32 32 32 35 33 33 33 33 33 33 33 33 33 33 33 33 33 33 33 33 33 37 32 32 32 32 32 32 32 32 32 32 34 31 36 32 32 32 32 32 32 32 32 32
32 32 32 32 32 32 32 32 32 34 31 31 31 31 31 31 31 31 31 31 31 31 31 31 31 31 31 36 32 32 32 32 32 32 32 32 32 32 34 31 36 32 32 32 32 32 32 32 32 32
32 32 32 32 32 32 32 32 32 34 31 31 31 31 31 31 31 31 31 31 31 31 31 31 31 31 31 36 32 32 32 32 32 32 32 32 32 32 34 31 36 32 32 32 32 32 32 32 32 32
32 32 32 32 32 32 32 32 32 34 31 31 31 31 31 31 31 31 31 31 31 31 31 31 31 31 31 36 32 32 32 32 32 32 32 32 32 32 34 31 36 32 32 32 32 32 32 32 32 32
32 32 32 32 32 32 32 32 32 34 31 31 31 31 31 31 31 31 31 31 31 31 31 31 31 31 31 36 32 32 32 32 32 32 32 32 32 32 34 31 36 32 32 32 32 32 32 32 32 32
32 32 32 32 32 32 32 32 32 34 31 31 31 31 31 31 31 31 31 31 31 31 31 31 31 31 31 36 32 32 32 32 32 32 32 32 32 32 34 31 36 32 32 32 32 32 32 32 32 32
32 32 32 32 32 32 32 32 32 34 31 31 31 31 31 31 31 31 31 31 31 31 31 31 31 31 31 44 33 33 33 33 33 33 33 33 33 33 42 31 36 32 32 32 32 32 32 32 32 32
32 32 32 32 32 32 32 32 32 34 31 31 31 31 31 31 31 31 31 31 31 31 31 31 31 31 31 31 31 31 31 31 31 31 31 31 31 31 31 31 36 32 32 32 32 32 32 32 32 32
32 32 32 32 32 32 32 32 32 39 38 38 38 38 38 38 38 38 38 38 38 38 38 38 38 38 38 38 38 38 38 38 38 38 38 38 38 38 38 38 40 32 32 32 32 32 32 32 32 32
32 32 32 32 32 32 32 32 32 32 32 32 32 32 32 32 32 32 32 32 32 32 32 32 32 32 32 32 32 32 32 32 32 32 32 32 32 32 32 32 32 32 32 32 32 32 32 32 32 32
32 32 32 32 32 32 32 32 32 32 32 32 32 32 32 32 32 32 32 32 32 32 32 32 32 32 32 32 32 32 32 32 32 32 32 32 32 32 32 32 32 32 32 32 32 32 32 32 32 32
32 32 32 32 32 32 32 32 32 32 32 32 32 32 32 32 32 32 32 32 32 32 32 32 32 32 32 32 32 32 32 32 32 32 32 32 32 32 32 32 32 32 32 32 32 32 32 32 32 32
32 32 32 32 32 32 32 32 32 32 32 32 32 32 32 32 32 32 32 32 32 32 32 32 32 32 32 32 32 32 32 32 32 32 32 32 32 32 32 32 32 32 32 32 32 32 32 32 32 32
32 32 32 32 32 32 32 32 32 32 32 32 32 32 32 32 32 32 32 32 32 32 32 32 32 32 32 32 32 32 32 32 32 32 32 32 32 32 32 32 32 32 32 32 32 32 32 32 32 32
