11 11 11 11 11 11 11 11 11 11 11 11 11 11 11 11 11 11 11 11 11 11 11 11 11 11 11 11 11 11 11 11 11 11 11 11 11 11 11 11 11 11 11 11 11 11 11 11 11 11 
11 11 11 11 11 11 11 11 11 11 11 11 11 11 11 11 11 11 11 11 11 11 11 11 11 11 11 11 11 11 11 11 11 11 11 11 11 11 11 11 11 11 11 11 11 11 11 11 11 11 
11 11 11 11 11 11 11 11 11 11 11 11 11 11 11 11 11 11 11 11 11 11 11 11 11 11 11 11 11 11 11 11 11 11 11 11 11 11 11 11 11 11 11 11 11 11 11 11 11 11 
11 11 11 11 11 11 11 11 11 11 11 11 11 11 11 11 11 11 11 11 11 11 11 11 11 11 11 11 11 11 11 11 11 11 11 11 11 11 11 11 11 11 11 11 11 11 11 11 11 11 
11 11 11 11 11 11 11 11 11 11 11 11 11 11 11 11 11 11 11 11 11 11 11 11 11 11 11 11 11 11 11 11 11 11 11 11 11 11 11 11 11 11 11 11 11 11 11 11 11 11 
11 11 11 11 11 11 11 11 11 11 11 11 11 11 11 11 11 11 11 11 11 11 11 11 11 11 11 11 11 11 11 11 11 11 11 11 11 11 11 11 11 11 11 11 11 11 11 11 11 11 
11 11 11 11 11 11 11 11 11 11 22 22 22 22 22 22 22 22 22 22 26 10 10 10 10 10 10 10 11 11 11 11 11 11 11 11 11 11 11 11 11 11 11 11 11 11 11 11 11 11
11 11 11 11 11 11 11 11 11 11 10 11 11 11 11 11 11 11 11 11 11 10 10 10 27 10 10 10 10 10 10 10 10 10 10 11 11 11 29 11 11 11 11 11 11 11 11 11 11 11
11 11 11 11 11 11 11 11 11 11 10 11 11 11 11 11 11 11 11 11 11 10 10 10 10 10 27 10 11 11 11 11 10 10 10 11 11 11 23 11 11 11 11 11 11 11 11 11 11 11
11 11 11 11 11 11 11 11 11 11 27 10 10 10 10 10 10 10 10 11 11 27 10 10 10 10 10 10 27 11 11 11 11 11 10 11 11 11 21 11 11 11 11 11 11 11 11 11 11 11
11 11 11 11 11 11 11 11 11 11 17 13 13 13 13 13 18 27 10 11 11 11 11 11 11 11 11 10 10 11 11 11 11 11 10 11 11 11 21 11 11 11 11 11 11 11 11 11 11 11
11 11 11 11 11 11 11 11 11 11 15 12 12 12 12 12 16 10 10 11 11 11 11 11 11 11 11 10 10 11 11 10 10 10 10 11 11 11 21 11 11 11 11 11 11 11 11 11 11 11
11 11 11 11 11 11 11 11 11 11 15 12 12 12 12 12 16 10 10 11 11 10 27 10 10 10 10 10 10 11 11 10 10 27 10 11 11 11 21 11 11 11 11 11 11 11 11 11 11 11
11 11 11 11 11 11 11 11 11 11 15 12 12 12 12 12 16 10 10 11 11 10 10 10 10 10 10 10 10 11 11 10 10 10 10 11 11 11 24 11 11 11 11 11 11 11 11 11 11 11
11 11 11 11 11 11 11 11 11 11 19 14 14 14 14 14 20 10 10 11 11 27 10 10 10 10 10 10 27 11 11 10 10 10 10 10 10 10 10 10 11 11 11 11 11 11 11 11 11 11
11 11 11 11 11 11 11 11 11 11 10 10 10 10 10 10 10 10 10 11 11 10 10 10 10 10 10 10 10 11 11 10 27 10 10 10 10 10 10 47 11 11 11 11 11 11 11 11 11 11
11 11 11 11 11 11 11 11 11 11 11 11 11 11 11 11 11 11 11 11 11 10 10 27 11 11 11 11 11 11 11 10 10 11 11 11 11 11 11 11 11 11 11 11 11 11 11 11 11 11
11 11 11 11 11 11 11 11 11 11 11 11 11 11 11 11 11 11 11 11 11 10 10 10 11 11 11 11 11 11 11 10 10 11 11 11 11 11 11 11 11 11 11 11 11 11 11 11 11 11
11 11 11 11 11 11 11 11 11 11 10 10 10 10 10 10 10 10 10 27 10 10 10 10 11 11 11 11 11 11 11 10 10 11 10 10 10 10 10 10 11 11 11 11 11 11 11 11 11 11
11 11 11 11 11 11 11 11 11 11 10 10 10 27 10 10 10 10 10 10 27 10 10 10 11 11 11 11 11 11 11 10 10 11 27 10 10 10 10 10 11 11 11 11 11 11 11 11 11 11
11 11 11 11 11 11 11 11 11 11 10 27 10 10 10 10 10 10 10 10 10 10 10 10 11 11 11 11 11 11 11 10 10 11 10 10 11 10 10 10 11 11 11 11 11 11 11 11 11 11
11 11 11 11 11 11 11 11 11 11 10 10 11 11 11 11 11 11 11 11 11 11 11 11 11 11 11 11 11 11 11 10 10 11 10 10 11 10 10 10 11 11 11 11 11 11 11 11 11 11
11 11 11 11 11 11 11 11 11 11 10 27 11 11 11 11 11 11 11 11 11 11 11 11 11 11 11 11 11 11 11 10 10 11 10 10 11 10 10 10 11 11 11 11 11 11 11 11 11 11
11 11 11 11 11 11 11 11 11 11 10 10 11 11 11 11 11 11 11 11 11 11 11 11 11 11 11 11 11 11 11 10 10 11 10 27 11 10 10 10 11 11 11 11 11 11 11 11 11 11
11 11 11 11 11 11 11 11 11 11 10 10 10 10 10 10 10 10 10 10 10 10 10 10 10 10 11 11 11 11 11 10 10 10 10 10 11 10 10 10 11 11 11 11 11 11 11 11 11 11
11 11 11 11 11 11 11 11 11 11 10 10 10 10 27 10 10 10 10 10 10 10 10 10 10 10 11 11 11 11 11 10 10 10 10 10 11 10 10 10 11 11 11 11 11 11 11 11 11 11
11 11 11 11 11 11 11 11 11 11 10 10 10 10 10 10 10 10 10 10 10 10 10 10 10 10 11 11 11 11 11 11 11 11 11 11 11 10 10 10 11 11 11 11 11 11 11 11 11 11
11 11 11 11 11 11 11 11 11 11 10 10 10 10 10 10 10 10 10 10 10 10 10 10 10 10 10 10 11 11 11 11 11 11 11 11 11 27 10 10 11 11 11 11 11 11 11 11 11 11
11 11 11 11 11 11 11 11 11 11 11 11 11 11 11 11 11 11 11 11 11 11 11 11 11 11 10 10 11 11 11 10 10 10 10 10 10 10 10 10 11 11 11 11 11 11 11 11 11 11
11 11 11 11 11 11 11 11 11 11 11 11 11 11 11 11 11 11 11 11 11 11 11 11 11 11 10 10 11 11 11 10 10 10 10 10 10 10 10 10 11 11 11 11 11 11 11 11 11 11
11 11 11 11 11 11 11 11 11 11 11 11 11 11 11 11 11 11 11 11 11 11 11 11 11 11 10 27 11 11 11 10 10 10 10 10 27 10 10 10 11 11 11 11 11 11 11 11 11 11
11 11 11 11 11 11 11 11 11 11 11 11 11 11 11 11 11 11 11 11 11 11 11 11 11 11 10 10 11 11 11 10 10 11 11 11 11 11 11 11 11 11 11 11 11 11 11 11 11 11
11 11 11 11 11 11 11 11 11 11 10 10 10 10 10 10 10 10 27 10 10 10 10 10 10 10 10 10 11 11 11 10 10 11 11 11 11 11 11 11 11 11 11 11 11 11 11 11 11 11
11 11 11 11 11 11 11 11 11 11 10 10 10 10 10 10 10 10 10 10 10 10 10 10 10 10 10 10 11 11 11 10 27 11 11 11 11 11 11 11 11 11 11 11 11 11 11 11 11 11
11 11 11 11 11 11 11 11 11 11 27 10 10 11 11 11 11 11 11 11 11 11 11 11 11 11 11 11 11 11 11 10 10 10 10 10 10 10 10 10 11 11 11 11 11 11 11 11 11 11
11 11 11 11 11 11 11 11 11 11 10 10 10 10 10 10 10 10 10 10 10 10 10 10 10 10 10 27 11 11 11 10 10 10 10 10 10 10 10 10 11 11 11 11 11 11 11 11 11 11
11 11 11 11 11 11 11 11 11 11 10 10 10 27 10 10 10 10 10 10 10 10 10 10 10 10 10 10 11 11 11 11 11 11 11 11 10 10 10 10 11 11 11 11 11 11 11 11 11 11
11 11 11 11 11 11 11 11 11 11 11 11 11 11 11 11 11 11 11 11 11 11 11 11 11 11 10 10 11 11 11 11 11 11 11 11 10 10 10 10 11 11 11 11 11 11 11 11 11 11
11 11 11 11 11 11 11 11 11 11 11 11 11 11 11 11 11 11 11 11 11 11 11 11 11 11 10 10 11 11 11 11 11 11 11 11 10 10 10 10 11 11 11 11 11 11 11 11 11 11
11 11 11 11 11 11 11 11 11 11 11 11 11 11 11 11 11 11 11 11 11 11 11 11 11 11 10 10 11 11 11 11 11 11 11 11 10 10 10 10 11 11 11 11 11 11 11 11 11 11
11 11 11 11 11 11 11 11 11 11 47 10 10 10 10 10 10 10 10 10 11 11 10 10 10 10 10 10 11 11 11 11 11 11 11 11 10 10 10 10 11 11 11 11 11 11 11 11 11 11
11 11 11 11 38 38 38 38 38 41 10 10 10 10 10 10 10 10 10 10 11 11 10 10 27 10 10 10 11 11 11 11 11 11 11 11 10 10 10 10 11 11 11 11 11 11 11 11 11 11
11 11 11 11 32 32 32 32 32 45 10 10 10 10 10 10 27 10 10 10 11 11 10 10 10 10 10 10 10 10 27 10 10 10 10 10 10 10 10 10 11 11 11 11 11 11 11 11 11 11
11 11 11 11 33 33 33 33 33 42 10 10 10 10 10 10 10 10 10 10 10 10 10 10 10 10 27 10 10 10 10 10 10 10 10 10 10 10 10 10 11 11 11 11 11 11 11 11 11 11
11 11 11 11 11 11 11 11 17 13 13 13 13 13 13 13 13 13 13 13 13 13 13 13 13 13 13 13 13 13 13 13 13 13 13 13 13 13 13 13 13 18 11 11 11 11 11 11 11 11 
11 11 11 11 11 11 11 11 15 12 12 12 12 12 12 12 12 12 12 12 12 12 12 12 12 12 12 12 12 12 12 12 12 12 12 12 12 12 12 12 12 16 11 11 11 11 11 11 11 11
11 11 11 11 11 11 11 11 15 12 12 12 12 12 12 12 12 12 12 12 12 12 12 12 12 12 12 12 12 12 12 12 12 12 12 12 12 12 12 12 12 16 11 11 11 11 11 11 11 11 
11 11 11 11 11 11 11 11 15 12 12 12 12 12 12 12 12 12 12 12 12 12 12 12 12 12 12 12 12 12 12 12 12 12 12 12 12 12 12 12 12 16 11 11 11 11 11 11 11 11 
11 11 11 11 11 11 11 11 15 12 12 12 12 12 12 12 12 12 12 12 12 12 12 12 12 12 12 12 12 12 12 12 12 12 12 12 12 12 12 12 12 16 11 11 11 11 11 11 11 11 
11 11 11 11 11 11 11 11 15 12 12 12 12 12 12 12 12 12 12 12 12 12 12 12 12 12 12 12 12 12 12 12 12 12 12 12 12 12 12 12 12 16 11 11 11 11 11 11 11 11